NO tex/tex_matrix.xpm
SO tex/tex_matrix.xpm
WE tex/tex_matrix.xpm
EA tex/tex_matrix.xpm

F 255,0,6
C 255,70,6

111111111111111
10000000000N001
100000000000011
100001111110111
100000000000001
100000000000001
100000000000001
100000000000001
100000000000001
100000000000001
100000000000001
100001101110001
100000000000001
100000000000001
111011101101111
111111101111111
111111101111111
100000000000001
100000000000001
100001101110001
100000000000001
100000000000001
111011111101111
111111111111111
